 ,*, , , ,*,*,* 
 ,*, ,*, , , , 
 ,*, ,*, ,*,*,*
 ,*, ,*,*,*,*,*
 , ,x,*, , , ,*
*,*, ,*, ,*, , 
 ,*, ,*, ,*, ,*
 , , , , ,*,/,*