 ,*, , , ,*,*,*
 ,*,*,*, , , , 
 ,*, ,*,*,*,*,*
 ,*, ,*,*,*,*,*
 , , ,*, , , ,*
*,*, ,*, ,*, ,*
 ,*, ,*,*,*, ,*
 , , , , ,*,/,*
