*,*, , , ,*,*,*
 ,*, ,*, , , , 
 ,*, ,*,*,*,*,*
 ,*, ,*,*,*,*,*
 , , ,*, , , ,*
*,*, ,*, ,*, ,*
 ,*, ,*, ,*, ,*
 , , , , ,*,/,*
